{
  "name": "town5",
  "version": 1,
  "dimensions": {
    "width": 35,
    "height": 35
  },
  "properties": {
    "type": "town",
    "encounters_enabled": false,
    "world_wrap": false
  },
  "spawn": {
    "x": 17,
    "y": 17,
    "direction": "down"
  },
  "tileset": [
    "260",
    "brick2",
    "brick3",
    "rock1",
    "399",
    "400",
    "398",
    "396",
    "393",
    "troof2",
    "troof1",
    "twall1",
    "175",
    "twall2",
    "177",
    "174",
    "181",
    "182",
    "184",
    "176"
  ],
  "tiles": [
    [0,0,0,0,0,0,0,0,0,0,0,0,0,0,0,0,0,0,0,0,0,0,0,0,0,0,0,0,0,0,0,0,0,0,0],
    [0,0,0,0,0,0,0,0,0,0,0,0,0,0,0,0,0,0,0,0,0,0,0,0,0,0,0,0,0,0,0,0,0,0,0],
    [0,0,0,0,0,0,0,0,0,0,0,0,0,0,0,0,0,0,0,0,0,0,0,0,0,0,0,0,0,0,0,0,0,0,0],
    [0,0,0,0,1,2,2,2,2,2,2,2,2,2,2,2,5,3,0,2,2,2,2,2,2,2,2,2,2,2,1,0,0,0,0],
    [0,0,0,0,1,4,6,6,0,0,0,0,0,0,0,0,0,3,0,0,0,6,6,6,6,6,6,6,0,0,1,4,0,0,0],
    [0,0,0,0,1,4,7,7,9,9,9,9,9,0,6,0,0,3,0,6,0,7,8,8,8,7,7,7,6,0,1,4,0,0,0],
    [0,0,0,0,1,4,8,8,10,10,10,10,10,4,7,0,0,3,0,7,0,9,9,9,9,9,9,9,7,0,1,4,0,0,0],
    [0,0,0,0,1,4,6,0,11,14,13,14,11,5,7,0,0,3,0,7,0,10,10,10,10,10,10,10,7,0,1,4,0,0,0],
    [0,0,0,0,1,4,7,6,6,0,3,0,0,0,8,0,0,3,0,8,0,10,10,10,10,10,10,10,7,0,1,4,0,0,0],
    [0,0,0,0,1,4,8,7,7,6,3,3,3,3,3,3,3,3,0,7,6,16,17,10,10,10,17,16,7,0,1,4,0,0,0],
    [0,0,0,0,1,4,0,8,7,7,0,0,0,6,6,6,0,3,0,7,7,12,11,18,16,18,11,12,8,0,1,4,0,0,0],
    [0,0,0,0,1,4,0,9,9,9,9,0,6,7,7,8,0,3,0,8,8,6,6,11,13,11,5,0,0,0,1,4,0,0,0],
    [0,0,0,0,1,4,0,10,10,10,10,4,7,7,8,0,0,3,0,0,0,7,7,0,3,0,0,0,0,0,1,4,0,0,0],
    [0,0,0,0,1,4,0,11,12,13,11,5,8,8,0,0,0,3,0,0,0,8,7,6,3,0,0,0,0,0,1,4,0,0,0],
    [0,0,0,0,1,4,0,0,0,6,6,6,7,0,0,0,0,3,0,0,0,0,7,7,3,0,0,0,0,0,1,4,0,0,0],
    [0,0,0,0,2,5,0,0,0,7,7,7,8,0,0,0,0,3,0,0,0,0,8,8,3,0,0,0,0,0,2,5,0,0,0],
    [0,0,0,0,0,0,0,0,0,8,8,8,0,0,0,0,0,3,0,0,0,0,0,0,3,0,0,0,0,0,0,0,0,0,0],
    [0,0,0,0,3,3,3,3,3,3,3,3,3,3,3,3,3,3,3,3,3,3,3,3,3,3,3,3,3,3,3,0,0,0,0],
    [0,0,0,0,0,0,0,6,0,6,0,0,0,0,0,0,0,3,0,0,0,0,0,0,0,0,0,0,0,0,0,0,0,0,0],
    [0,0,0,0,1,0,0,7,0,7,0,0,0,0,0,0,0,3,0,0,0,0,0,0,0,0,0,0,0,0,1,0,0,0,0],
    [0,0,0,0,1,4,0,8,6,7,6,6,6,6,0,0,0,3,0,0,0,0,0,0,6,6,6,6,6,6,1,4,0,0,0],
    [0,0,0,0,1,4,0,6,7,8,7,7,7,7,6,0,0,3,0,0,0,0,0,6,7,7,7,7,7,7,1,4,0,0,0],
    [0,0,0,0,1,4,6,7,8,0,7,8,8,7,7,6,0,3,0,0,0,0,6,7,7,8,7,8,7,7,1,4,0,0,0],
    [0,0,0,0,1,4,7,7,0,0,8,7,7,8,8,7,6,3,0,0,0,6,7,7,8,0,8,0,8,7,1,4,0,0,0],
    [0,0,0,0,1,4,7,8,0,0,0,8,8,0,0,7,7,3,0,0,6,7,7,8,0,0,0,0,0,7,1,4,0,0,0],
    [0,0,0,0,1,4,7,9,9,9,9,9,9,9,0,8,7,3,0,0,7,7,7,7,0,9,9,9,0,8,1,4,0,0,0],
    [0,0,0,0,1,4,8,10,10,10,10,10,10,10,4,7,8,3,0,0,7,8,7,8,0,10,10,10,4,7,1,4,0,0,0],
    [0,0,0,0,1,4,7,10,10,10,11,15,13,15,5,7,0,3,0,0,7,7,7,0,6,11,13,19,7,7,1,4,0,0,0],
    [0,0,0,0,1,4,7,11,13,11,5,0,3,0,6,7,0,3,0,0,8,8,8,0,8,0,3,0,8,8,1,4,0,0,0],
    [0,0,0,0,1,4,8,0,3,0,0,0,3,0,8,8,0,3,3,3,3,3,3,3,3,3,3,0,0,0,1,4,0,0,0],
    [0,0,0,0,1,4,0,0,3,3,3,3,3,3,3,3,3,3,0,0,0,0,0,0,0,0,0,0,0,0,1,4,0,0,0],
    [0,0,0,0,2,2,2,2,2,2,2,2,2,2,2,2,5,3,0,2,2,2,2,2,2,2,2,2,2,2,2,5,0,0,0],
    [0,0,0,0,0,0,0,0,0,0,0,0,0,0,0,0,0,0,0,0,0,0,0,0,0,0,0,0,0,0,0,0,0,0,0],
    [0,0,0,0,0,0,0,0,0,0,0,0,0,0,0,0,0,0,0,0,0,0,0,0,0,0,0,0,0,0,0,0,0,0,0],
    [0,0,0,0,0,0,0,0,0,0,0,0,0,0,0,0,0,0,0,0,0,0,0,0,0,0,0,0,0,0,0,0,0,0,0]
  ],
  "attribute_overrides": [
    { "x": 17, "y": 3, "attribute": 3 },
    { "x": 18, "y": 3, "attribute": 3 },
    { "x": 21, "y": 6, "attribute": 5 },
    { "x": 22, "y": 6, "attribute": 5 },
    { "x": 23, "y": 6, "attribute": 5 },
    { "x": 24, "y": 6, "attribute": 5 },
    { "x": 25, "y": 6, "attribute": 5 },
    { "x": 26, "y": 6, "attribute": 5 },
    { "x": 27, "y": 6, "attribute": 5 },
    { "x": 9, "y": 13, "attribute": 4 },
    { "x": 4, "y": 16, "attribute": 3 },
    { "x": 30, "y": 16, "attribute": 3 },
    { "x": 4, "y": 17, "attribute": 3 },
    { "x": 30, "y": 17, "attribute": 3 },
    { "x": 4, "y": 18, "attribute": 3 },
    { "x": 30, "y": 18, "attribute": 3 },
    { "x": 8, "y": 28, "attribute": 4 },
    { "x": 17, "y": 31, "attribute": 3 },
    { "x": 18, "y": 31, "attribute": 3 }
  ]
}
