{
  "name": "TOWN1",
  "version": 1,
  "dimensions": {
    "width": 35,
    "height": 35
  },
  "properties": {
    "type": "town",
    "encounters_enabled": false,
    "world_wrap": false
  },
  "spawn": {
    "x": 17,
    "y": 17,
    "direction": "down"
  },
  "tileset": [
    "medow",
    "brick2",
    "brick3",
    "rock1",
    "171",
    "170",
    "408",
    "troof2",
    "troof1",
    "twall1",
    "178",
    "175",
    "179",
    "twall2",
    "174",
    "176",
    "180",
    "177",
    "406",
    "407",
    "pbrick",
    "405",
    "172",
    "403",
    "220",
    "186",
    "185",
    "181",
    "182",
    "404",
    "184"
  ],
  "tiles": [
    [0,0,0,0,0,0,0,0,0,0,0,0,0,0,0,0,0,0,0,0,0,0,0,0,0,0,0,0,0,0,0,0,0,0,0],
    [0,0,0,0,0,0,0,0,0,0,0,0,0,0,0,0,0,0,0,0,0,0,0,0,0,0,0,0,0,0,0,0,0,0,0],
    [0,0,0,0,0,0,0,0,0,0,0,0,0,0,0,0,0,0,0,0,0,0,0,0,0,0,0,0,0,0,0,0,0,0,0],
    [0,0,0,0,1,2,2,2,2,2,2,2,2,2,20,2,5,3,0,2,2,2,2,2,2,2,2,2,2,2,1,0,0,0,0],
    [0,0,0,0,1,4,0,0,0,0,0,0,0,0,0,0,0,3,0,0,0,0,0,0,0,0,0,0,0,0,1,4,0,0,0],
    [0,0,0,0,1,4,0,0,7,7,7,7,7,0,0,0,0,3,0,0,0,0,0,0,0,0,0,0,0,0,1,4,0,0,0],
    [0,0,0,0,1,4,0,0,8,8,8,8,8,4,21,0,0,3,0,0,0,7,7,7,7,7,7,7,0,0,1,4,0,0,0],
    [0,0,0,0,1,4,0,0,9,14,13,14,9,5,0,0,0,3,0,0,0,8,8,8,8,8,8,8,0,0,1,4,0,0,0],
    [0,0,0,0,1,4,0,0,0,0,3,0,0,0,0,0,0,3,0,0,0,8,8,8,8,8,8,8,4,0,1,4,0,0,0],
    [0,0,0,0,1,4,0,0,0,0,3,3,3,3,3,3,3,3,0,0,0,27,28,8,8,8,28,27,4,0,1,4,0,0,0],
    [0,0,0,0,1,4,0,0,0,0,0,0,0,0,0,0,0,3,0,0,0,11,9,30,27,30,9,11,5,0,1,4,0,0,0],
    [0,0,0,0,1,4,0,7,7,7,7,0,0,0,0,0,0,3,0,0,0,0,29,9,13,9,5,0,0,0,1,4,0,0,0],
    [0,0,0,0,1,4,0,8,8,8,8,4,0,0,0,0,0,3,0,0,0,0,0,0,3,0,0,0,0,0,1,4,0,0,0],
    [0,0,0,0,1,4,0,9,11,13,9,5,0,0,0,0,0,3,0,0,0,0,0,0,3,0,0,0,0,0,1,4,0,0,0],
    [0,0,0,0,1,4,0,0,0,0,0,0,0,0,0,0,3,3,3,0,0,0,0,0,3,0,0,0,0,0,1,4,0,0,0],
    [0,0,0,0,2,5,0,0,0,0,0,0,0,0,0,3,3,0,3,3,0,0,0,0,3,0,0,0,0,0,2,5,0,0,0],
    [0,0,0,0,0,0,6,0,0,0,0,0,0,0,3,3,22,0,22,3,3,0,0,0,3,0,0,0,0,0,0,0,0,0,0],
    [0,0,0,0,3,3,3,3,3,3,3,3,3,3,3,0,0,22,0,0,3,3,3,3,3,3,3,3,3,3,3,0,0,0,0],
    [0,0,0,0,0,0,0,0,0,0,0,0,0,0,3,3,22,23,22,3,3,0,24,24,24,24,24,24,24,24,0,0,0,0,0],
    [0,0,0,0,1,0,0,0,0,0,0,0,0,0,0,3,3,0,3,3,0,24,25,25,25,25,25,25,25,25,1,0,0,0,0],
    [0,0,0,0,1,4,0,0,0,0,0,0,0,0,0,0,3,3,3,0,24,25,25,25,25,25,25,25,25,25,1,4,0,0,0],
    [0,0,0,0,1,4,0,0,0,0,0,0,0,0,0,0,0,3,0,24,25,25,25,25,25,25,25,25,25,25,1,4,0,0,0],
    [0,0,0,0,1,4,0,10,12,12,12,16,0,0,0,0,0,3,0,25,25,25,25,25,25,25,25,25,25,25,1,4,0,0,0],
    [0,0,0,0,1,4,0,0,0,0,0,0,19,0,0,0,0,3,0,25,25,25,25,25,25,25,25,25,25,25,1,4,0,0,0],
    [0,0,0,0,1,4,0,0,0,0,0,0,0,0,0,0,0,3,0,25,25,25,25,25,25,25,25,25,25,25,1,4,0,0,0],
    [0,0,0,0,1,4,0,7,7,7,7,7,7,7,0,0,0,3,0,25,25,25,25,25,26,7,7,7,26,25,1,4,0,0,0],
    [0,0,0,0,1,4,0,8,8,8,8,8,8,8,4,0,0,3,0,25,25,25,25,25,0,8,8,8,4,25,1,4,0,0,0],
    [0,0,0,0,1,4,0,8,8,8,9,17,13,9,5,0,0,3,0,25,25,25,25,25,0,9,13,9,5,25,1,4,0,0,0],
    [0,0,0,0,1,4,0,9,13,15,5,0,3,0,0,0,0,3,0,25,25,25,25,25,24,24,0,24,24,25,1,4,0,0,0],
    [0,0,0,0,1,4,0,0,3,0,0,18,3,0,0,0,0,3,0,26,26,26,26,26,26,26,0,26,26,26,1,4,0,0,0],
    [0,0,0,0,1,4,0,0,3,3,3,3,3,3,3,3,3,3,0,0,0,0,0,0,0,0,0,0,0,0,1,4,0,0,0],
    [0,0,0,0,2,2,2,2,2,2,2,2,2,2,2,2,5,3,0,2,2,2,2,2,2,2,2,2,2,2,2,5,0,0,0],
    [0,0,0,0,0,0,0,0,0,0,0,0,0,0,0,0,0,0,0,0,0,0,0,0,0,0,0,0,0,0,0,0,0,0,0],
    [0,0,0,0,0,0,0,0,0,0,0,0,0,0,0,0,0,0,0,0,0,0,0,0,0,0,0,0,0,0,0,0,0,0,0],
    [0,0,0,0,0,0,0,0,0,0,0,0,0,0,0,0,0,0,0,0,0,0,0,0,0,0,0,0,0,0,0,0,0,0,0]
  ],
  "attribute_overrides": [
    { "x": 15, "y": 2, "attribute": 5 },
    { "x": 16, "y": 2, "attribute": 5 },
    { "x": 17, "y": 2, "attribute": 5 },
    { "x": 18, "y": 2, "attribute": 5 },
    { "x": 19, "y": 2, "attribute": 5 },
    { "x": 16, "y": 3, "attribute": 3 },
    { "x": 17, "y": 3, "attribute": 3 },
    { "x": 18, "y": 3, "attribute": 3 },
    { "x": 9, "y": 13, "attribute": 4 },
    { "x": 3, "y": 16, "attribute": 5 },
    { "x": 4, "y": 16, "attribute": 3 },
    { "x": 30, "y": 16, "attribute": 3 },
    { "x": 31, "y": 16, "attribute": 5 },
    { "x": 3, "y": 17, "attribute": 5 },
    { "x": 4, "y": 17, "attribute": 3 },
    { "x": 30, "y": 17, "attribute": 3 },
    { "x": 31, "y": 17, "attribute": 5 },
    { "x": 3, "y": 18, "attribute": 5 },
    { "x": 4, "y": 18, "attribute": 3 },
    { "x": 30, "y": 18, "attribute": 3 },
    { "x": 31, "y": 18, "attribute": 5 },
    { "x": 22, "y": 19, "attribute": 8 },
    { "x": 23, "y": 19, "attribute": 8 },
    { "x": 24, "y": 19, "attribute": 8 },
    { "x": 25, "y": 19, "attribute": 8 },
    { "x": 26, "y": 19, "attribute": 8 },
    { "x": 27, "y": 19, "attribute": 8 },
    { "x": 28, "y": 19, "attribute": 8 },
    { "x": 29, "y": 19, "attribute": 8 },
    { "x": 21, "y": 20, "attribute": 8 },
    { "x": 20, "y": 21, "attribute": 8 },
    { "x": 19, "y": 22, "attribute": 8 },
    { "x": 25, "y": 25, "attribute": 5 },
    { "x": 26, "y": 25, "attribute": 5 },
    { "x": 27, "y": 25, "attribute": 5 },
    { "x": 16, "y": 31, "attribute": 3 },
    { "x": 17, "y": 31, "attribute": 3 },
    { "x": 18, "y": 31, "attribute": 3 },
    { "x": 15, "y": 32, "attribute": 5 },
    { "x": 16, "y": 32, "attribute": 5 },
    { "x": 17, "y": 32, "attribute": 5 },
    { "x": 18, "y": 32, "attribute": 5 },
    { "x": 19, "y": 32, "attribute": 5 }
  ]
}
